38
12
9 0 0 0 0 0 0 0 0 0 0 0 0 0 0 0 0 21 21 0 0 0 0 0 0 0 7 0 0 0 0 0 0 0 0 0 0 0 
9 0 0 0 0 0 0 0 0 0 0 0 0 0 0 0 0 21 21 0 0 0 0 0 0 0 7 0 0 0 0 0 0 0 0 0 0 20 
9 0 0 0 0 0 0 0 0 0 0 0 1 5 5 3 0 1 2 3 0 0 0 0 0 0 7 0 0 0 0 0 0 0 0 0 0 19 
1 2 2 2 2 2 2 2 3 0 0 0 0 0 0 0 0 21 21 9 0 0 0 1 5 3 7 0 0 0 1 2 3 0 0 1 2 2 
7 8 8 8 8 8 8 8 9 0 0 0 0 0 0 0 0 21 21 9 0 0 0 0 0 0 7 3 0 0 0 0 0 0 0 0 0 7 
9 0 0 0 0 0 0 0 0 0 0 1 5 3 0 0 0 21 21 9 0 0 0 0 0 0 7 0 0 0 0 0 0 0 0 0 0 7 
9 0 0 0 0 0 0 0 0 0 0 0 0 0 0 0 0 21 21 9 1 5 3 0 0 0 7 2 2 2 5 5 3 0 0 0 0 7 
9 0 0 0 0 0 0 0 0 0 0 0 0 0 0 1 2 2 2 9 0 0 0 0 0 0 0 0 0 0 0 0 0 0 0 0 0 7 
9 0 0 0 0 0 0 0 0 0 0 0 0 0 0 0 0 21 21 9 0 0 0 0 0 0 0 0 0 0 0 0 0 0 1 5 3 7 
9 0 0 0 0 1 5 3 0 0 1 2 2 2 3 0 0 21 21 9 0 0 0 0 0 0 0 0 0 0 0 0 0 0 0 0 0 7 
1 2 2 3 0 0 0 0 0 0 7 8 8 8 9 0 0 21 21 9 1 2 2 2 2 2 2 2 2 2 2 2 2 2 2 2 2 2 
7 8 8 9 17 17 17 17 17 17 7 8 8 8 9 17 17 21 21 9 7 8 8 8 8 8 8 8 8 8 8 8 8 8 8 8 8 8 
