50
25
0,0,0,0,0,0,0,28,28,0,0,0,0,0,0,0,0,0,0,0,0,0,0,0,0,28,28,28,0,0,0,0,22,22,22,0,0,0,0,0,0,0,0,0,0,0,0,0,0,20,
0,0,0,0,0,0,0,28,28,0,0,0,0,0,0,0,0,0,0,0,0,0,0,0,0,28,28,28,0,0,0,0,22,22,22,0,0,0,0,0,0,0,0,0,0,0,0,0,0,21,
0,0,0,0,0,0,0,28,28,0,0,25,0,0,0,0,0,0,0,0,0,0,0,25,0,28,28,28,0,0,0,0,22,22,22,0,0,0,0,0,0,0,0,0,0,0,0,0,0,21,
0,0,0,0,0,25,0,28,28,0,7,8,9,0,0,0,0,0,0,0,0,0,7,8,9,28,28,28,0,0,0,0,22,22,22,0,0,0,0,0,0,0,0,0,0,0,0,27,0,19,
0,0,0,0,7,8,9,28,28,0,0,0,0,0,0,0,25,0,0,0,0,0,0,0,0,28,28,28,0,0,0,0,22,22,22,0,0,0,0,0,0,0,0,0,0,0,0,7,8,9,
0,0,0,0,0,0,0,28,28,0,0,0,0,0,0,7,8,9,0,0,0,0,0,0,0,28,28,28,0,0,0,0,22,22,22,0,0,0,0,0,0,0,25,0,0,0,0,0,0,0,
0,0,0,0,0,0,0,28,28,0,0,0,0,0,0,0,0,0,0,0,0,0,0,0,0,28,28,28,0,0,0,0,22,22,22,0,0,0,0,0,0,0,7,8,9,0,0,0,0,0,
0,27,0,27,25,0,0,28,28,0,0,0,0,0,0,25,0,0,0,0,0,0,0,0,0,28,28,28,0,0,25,0,22,22,22,0,0,0,0,0,0,0,0,0,0,0,0,0,0,0,
2,2,2,2,2,2,2,2,2,2,2,2,2,2,2,2,2,2,2,2,2,2,2,2,2,2,2,2,2,2,2,2,2,2,2,2,2,2,2,3,0,0,0,0,0,0,0,0,0,0,
5,5,5,5,5,5,5,5,5,5,5,5,5,5,5,5,5,5,5,5,5,5,5,5,5,5,5,5,5,5,5,5,5,5,5,5,5,5,5,5,0,0,0,0,25,0,0,0,0,0,
5,5,5,5,5,5,5,5,5,5,5,5,5,5,5,5,5,5,5,5,5,5,5,5,5,5,5,5,5,5,5,5,5,5,5,5,5,5,5,6,0,0,7,8,9,0,0,0,0,0,
0,0,0,0,0,0,0,28,28,0,0,0,0,0,0,0,0,0,0,0,0,0,0,0,0,28,28,28,0,0,0,0,22,22,22,0,0,0,0,0,0,0,0,0,0,0,0,0,25,0,
0,0,0,0,0,0,0,28,28,0,0,0,0,0,0,0,0,0,0,0,0,0,0,0,0,28,28,28,0,0,0,0,22,22,22,0,0,0,0,0,0,0,0,0,0,0,0,7,8,9,
0,0,0,0,0,0,0,28,28,0,0,0,0,0,0,0,0,0,0,0,0,0,0,0,0,28,28,28,0,0,0,0,22,22,22,0,0,0,0,0,0,0,25,0,0,0,0,0,0,0,
0,0,0,0,0,0,0,28,28,0,0,0,0,0,0,0,0,0,0,0,0,0,0,0,0,28,28,28,0,0,0,0,22,22,22,0,0,0,0,0,0,0,7,8,9,0,0,0,0,0,
0,0,0,0,0,0,0,28,28,0,0,0,0,0,0,0,0,0,0,0,0,0,0,0,0,28,28,28,0,0,0,0,22,22,22,0,0,0,0,0,0,0,0,0,0,0,0,0,25,0,
0,0,0,0,0,0,0,28,28,0,0,0,0,0,0,0,25,0,0,0,0,0,0,0,0,28,28,28,0,0,0,0,22,22,22,0,0,0,0,0,0,0,0,0,0,0,0,7,8,9,
0,0,0,0,0,0,0,28,28,0,0,0,0,0,0,7,8,9,0,0,0,0,0,0,0,28,28,28,0,0,0,0,22,22,22,0,0,0,0,0,0,0,0,25,0,0,0,0,0,0,
0,0,0,0,0,0,0,28,28,0,0,25,0,0,0,0,0,0,0,0,0,25,0,0,0,28,28,28,0,0,0,0,22,22,22,0,0,0,0,0,0,0,7,8,9,0,0,0,0,0,
0,0,0,0,0,0,0,28,28,0,7,8,9,0,0,0,0,0,0,0,7,8,9,0,0,28,28,28,0,0,0,0,22,22,22,0,0,0,0,0,0,0,0,0,0,0,0,0,25,0,
0,0,0,0,0,0,0,28,28,0,0,0,0,0,0,0,0,0,0,0,0,0,0,0,0,28,28,28,0,0,0,0,22,22,22,0,0,0,0,0,0,0,0,0,0,0,0,7,8,9,
27,0,0,27,25,0,0,28,28,0,0,0,0,0,0,25,0,0,0,0,0,0,0,0,25,28,28,28,0,0,0,0,22,22,22,0,0,0,25,0,0,0,0,0,0,25,0,0,0,0,
2,2,2,2,2,2,2,2,2,2,2,2,2,2,2,2,2,2,2,2,2,2,2,2,2,2,2,2,2,3,0,0,22,22,1,2,2,2,2,2,2,2,2,2,2,2,2,2,2,2,
5,5,5,5,5,5,5,5,5,5,5,5,5,5,5,5,5,5,5,5,5,5,5,5,5,5,5,5,6,6,0,0,22,22,4,5,5,5,5,5,5,5,5,5,5,5,5,5,5,5,
5,5,5,5,5,5,5,5,5,5,5,5,5,5,5,5,5,5,5,5,5,5,5,5,5,5,5,5,6,6,23,23,22,22,4,5,5,5,5,5,5,5,5,5,5,5,5,5,5,5