29
20
0,0,0,0,0,0,0,0,0,0,0,0,0,0,0,0,0,0,0,0,0,0,0,0,0,0,0,0,20,
0,0,0,0,0,0,0,0,0,0,0,0,0,0,0,0,0,0,0,0,0,0,0,0,0,0,0,0,21,
0,0,0,0,0,0,0,0,0,0,0,0,0,0,0,0,0,0,0,0,0,0,0,0,0,0,0,0,21,
0,0,0,0,0,0,0,0,0,0,0,0,0,0,0,0,0,0,0,0,0,0,0,0,0,0,27,0,19,
0,0,0,0,0,0,0,0,0,0,0,0,0,0,0,0,10,11,12,0,0,13,14,14,14,14,14,14,14,
27,0,27,0,0,0,0,0,0,0,0,0,0,0,0,0,0,0,0,0,0,16,16,16,16,16,16,17,18,
13,14,15,0,0,0,0,0,0,0,0,0,0,0,0,0,10,11,12,0,0,0,0,0,0,0,0,0,0,
16,17,18,0,0,0,0,0,0,0,0,0,0,0,0,0,0,0,0,0,0,0,0,0,0,0,0,0,0,
16,17,18,0,0,0,0,0,0,0,0,0,0,0,0,0,0,0,0,0,13,14,15,0,0,0,0,0,0,
16,17,18,0,0,0,0,0,0,0,0,0,0,0,0,0,0,0,0,27,0,0,0,0,0,13,15,0,0,
16,17,18,0,0,0,0,0,0,0,0,0,0,0,0,0,0,0,0,21,0,0,0,0,0,0,0,0,0,
16,17,18,0,0,0,0,0,0,0,0,0,0,0,0,0,0,0,0,21,0,0,13,15,0,0,0,0,0,
0,0,0,0,0,0,0,0,0,0,0,0,0,0,0,0,0,0,0,21,0,0,0,0,0,0,0,10,11,
0,0,0,0,0,0,0,0,0,0,0,0,0,0,0,0,0,0,0,21,0,0,0,0,0,0,0,0,0,
0,0,25,0,0,0,0,0,0,0,0,0,0,0,0,0,0,0,0,21,0,0,0,0,0,0,0,0,0,
0,10,11,12,0,0,0,0,0,0,0,0,0,0,0,0,0,0,0,21,0,0,10,11,12,0,0,0,0,
0,0,0,0,0,0,25,0,0,0,0,0,0,0,0,0,0,25,0,21,0,0,0,0,0,0,0,0,0,
0,0,0,13,14,14,14,14,14,14,14,14,14,14,14,15,14,14,14,14,0,0,0,0,0,0,0,0,0,
24,24,24,16,16,16,16,16,16,16,16,16,16,16,16,17,18,17,17,17,24,24,24,24,24,24,24,24,24,
16,17,18,16,17,18,18,18,18,18,18,18,18,18,18,18,16,16,16,17,17,17,17,17,17,17,17,17,17